##########
# #     ##
# ##### ##
#    # ###
#### #   #
#### ### #
##       #
##########