####################
#    #        #    #
# ## #  ####  # ## #
#                  #
###  ##########  ###
#                  #
# ## #  ####  # ## #
#    #        #    >
####################