##########
# #    ###
# ####  ##
#    # ###
#### #   #
#### ### #
##       #
##########